1111111111111
1001000000001
100000000C001
10C0000000001
1000011111001
1P0011E00C001
1111111111111
