1111111111111
1001000000001
1111111111111